111111111111111111111111111111111111
111P00C00000000000000000000000000001
111111111111111111111111111111111001
100000000000000000000000000000000001
100C00111111111111111111111111111111
1000000000000000000000000000000000C1
1000C0001111111111000111111111111111
1C00000C1000000011000000000000000001
111111111011111011111111111111111001
10000000001C0C1000000000000000000001
1011111111100011110C0111111111111111
101000000000C00001111100000000000001
1000000000001000000000000000000000E1
111111111111111111111111111111111111